1111111111111111111111111111
1C00000M000001100000000000C1
1011110111110110111110111101
101111C11111011011111C111101
1011110111110110111110111101
100M000000000CC0000000000001
100C00011000011000011000C001
10000001100001100001100M0001
1011110110000000000110111101
1011110110111001110110111101
1000000110100000010110000001
10000001101E0000P10110000001
1011110110111111110110111101
1011110110111111110110111101
1C111101101111111101101111C1
1111111111111111111111111111