1111111111111111111111111111
1111111111111111111111111111
1011110111110110111110111101
1011111111101101111111110111
1011110111110110111110111101
1011110110111111110110111101
1011110110111111110110111101
10000001CP100011000011000001
1000000111000110000110000001
1000000000000000000000000001
1000000110100000010110000001
1000000110100000101100000011
1000000000C00000E00000000001
1000000000000000000000000001
1000000000000000000000000001
1011110110111111111011011101
1111111111111111111111111111