11111111111111111
10000000000000001
100C0011100000001
10000000000000111
10C00000000C00001
10000000EP0000001
100100000C0000001
1000C00000000C101
10000000C00000001
11111111111111111