1111111111
1000000P01
1000000001
10E0000001
1000000001
1000000C01
1111111111