1111111111
1E000P00C1
10000000C1
1111111111